id,student_admin,registration,surname,fullnames,gender,class,school,gname,phone,email,stock,size,quantity,amount,total_amount,paid,total,balance,status,method,date,term
23,2485,1010,OCHIENG,TERESIA OLUKUSI,Female,Class 5,UPPER,HENRY  OCHIENG,0727654699,,Shirts,MD,0,150,150,0,0,150,WITH BALANCE,,2017-07-03,TWO
24,2485,,OCHIENG,TERESIA OLUKUSI,Female,Class 5,UPPER,HENRY  OCHIENG,0727654699,,Shirts,MD,1,150,150,150,150,0,FULL PAID,BANK SLIP,2017-07-03,TWO
25,1998,1013,JOH   ODIWUOR,FELIX        OTIENO          ,Male,Class 3,LOWER,JOHN ODIWUOR,0726309657,,Shirts,MD,0,150,150,0,0,150,WITH BALANCE,,2017-07-03,TWO
26,1998,,JOH   ODIWUOR,FELIX        OTIENO          ,Male,Class 3,LOWER,JOHN ODIWUOR,0726309657,,Shirts,MD,2,150,300,300,300,0,FULL PAID,BANK SLIP,2017-07-03,TWO
27,2485,,OCHIENG,TERESIA OLUKUSI,Female,Class 5,UPPER,HENRY  OCHIENG,0727654699,,Shirts,MD,1,150,150,150,150,0,FULL PAID,BANK SLIP,2017-07-04,TWO
28,2485,1010,OCHIENG,TERESIA OLUKUSI,Female,Class 5,UPPER,HENRY  OCHIENG,0727654699,,Shorts,32,0,300,300,0,0,300,WITH BALANCE,,2017-07-03,TWO
29,2485,,OCHIENG,TERESIA OLUKUSI,Female,Class 5,UPPER,HENRY  OCHIENG,0727654699,,Shorts,32,1,300,300,300,300,0,FULL PAID,BANK SLIP,2017-07-05,TWO
30,2493,1015, OTIENO,EMMANUEL ABUOGA,Male,Class 5,UPPER,GEORGE   OTIENO,0724825972,,Shirts,MD,0,150,150,0,0,150,WITH BALANCE,,2017-07-04,TWO
31,2493,, OTIENO,EMMANUEL ABUOGA,Male,Class 5,UPPER,GEORGE   OTIENO,0724825972,,Shirts,MD,1,150,150,150,150,0,FULL PAID,CASH,2017-07-04,TWO
